NO ./Sprites/north.xpm
SO ./Sprites/south.xpm
WE ./Sprites/west.xpm
EA ./Sprites/east.xpm

F 255,100,0
C 255,100,0

        1111111111111111111111111
        1000000000110000000000001
        1011000001110000000000001
        1001000000000000000000001
111111111011000001110000000000001
100000000011000001110011111111111
111101111111110111000000100011
11110111111111011101010010001
11000000110101011100000010001
10000000000000000000000010001
1000000000000000110101001001111
11000001110101011111011010W01
11110111 1110101 101111000001
11111111 1111111 111111111111
